0000000000000000000000000000000000000000000000000000000000000000000000000000000000000000000000000000
a-99ao+150os4100000000000000000000000000000000000000000000000000000000000000000000000000000000000000
a-99ao+150os4200000000000000000000000000000000000000000000000000000000000000000000000000000000000000
a-99ao+150os4100000000000000000000000000000000000000000000000000000000000000000000000000000000000000
a-99ao+300os4200000000000000000000000000000000000000000000000000000000000000000000000000000000000000
a-99ao+300os4100000000000000000000000000000000000000000000000000000000000000000000000000000000000000
a-99ao+300os4200000000000000000000000000000000000000000000000000000000000000000000000000000000000000
a+720ao+300os030000000000000000000000000000000000000000000000000000000000000000000000000000000000000
a+720ao+300os04000000000000000000000000000000000000000000000a-99ao+15os51000000000000000000000000000
a-99ao+15os5100000000000000000000000000000000000000000000000a-99ao+15os51000000000000000000000000000
a-99ao+15os51000000000000000000000000000000000000000000000000000000000000000000000000000000000000000
a-99ao+15os51000000000000000000000000000000000000000000000000000000000000000000000000000000000000000
a-99ao+15os51000000000000000000000000000000000000000000000000000000000000000000000000000000000000000
a-99ao+15os51000000000000000000000000000000000000000000000000000000000000000000000000000000000000000
0000000000000000000000000000000000000000000000000000000000000000000000000000000000000000000000000000
000000000000000000000000000000000000000000000000000000000000a-99ao+15os51000000000000000000000000000
000000000000000000000000000000000000000000000000000000000000a-99ao+15os51000000000000000000000000000
000000000000000000000000000000000000000000000000000000000000a-99ao+15os51000000000000000000000000000
0000000000000000000000000000000000000000000000000000000000000000000000000000000000000000000000000000
a+720ao-99os7200000000000000000000000000000000000000000000000000000000000000000000000000000000000000
a+720ao-99os72000000000000000000000000000000000000000000000a-99ao+15os510000000000000000000000000000
000000000000000000000000000000000000000000000000000000000000a-99ao+15os51000000000000000000000000000
a+720ao-99os7200000000000000000000000000000000000000000000000000000000000000000000000000000000000000
a+720ao-99os72000000000000000000000000000000000000000000000a-99ao+15os510000000000000000000000000000
a+600ao+50os7500000000000000000000000000000000000000000000000000000000000000000000000000000000000000
a+720ao-99os7200000000000000000000000000000000000000000000000000000000000000000000000000000000000000
a+720ao-99os72000000000000000000000000000000000000000000000a-99ao+300os42000000000000000000000000000
00000000000000000000000000000000000000000000000000000000000a-99ao+300os42000000000000000000000000000
00000000000000000000000000000000000000000000000000000000000a-99ao+300os42000000000000000000000000000
0000000000000000000000000000000000000000000000000000000000000000000000000000000000000000000000000000
00000000000000000000000000000000000000000000000000000000000a-99ao+300os42000000000000000000000000000
00000000000000000000000000000000000000000000000000000000000a-99ao+300os42000000000000000000000000000
00000000000000000000000000000000000000000000000000000000000a+720ao+-99os7300000000000000000000000000
0000000000000000000000000000000000000000000000000000000000000000000000000000000000000000000000000000
000000000000000000000000000000000000000000000000000000000000a-99ao+15os51000000000000000000000000000
a-99ao+15os5100000000000000000000000000000000000000000000000a-99ao+15os51000000000000000000000000000
a-99ao+15os51000000000000000000000000000000000000000000000000000000000000000000000000000000000000000
a-99ao+15os51000000000000000000000000000000000000000000000000000000000000000000000000000000000000000
a-99ao+15os51000000000000000000000000000000000000000000000000000000000000000000000000000000000000000
a-99ao+15os51000000000000000000000000000000000000000000000000000000000000000000000000000000000000000
0000000000000000000000000000000000000000000000000000000000000000000000000000000000000000000000000000
a+600ao+480os14000000000000000000000000000000000000000000000a-99ao+15os51000000000000000000000000000
000000000000000000000000000000000000000000000000000000000000a-99ao+15os51000000000000000000000000000
000000000000000000000000000000000000000000000000000000000000a-99ao+15os51000000000000000000000000000
0000000000000000000000000000000000000000000000000000000000000000000000000000000000000000000000000000
0000000000000000000000000000000000000000000000000000000000000000000000000000000000000000000000000000
000000000000000000000000000000000000000000000000000000000000a-99ao+15os51000000000000000000000000000
000000000000000000000000000000000000000000000000000000000000a-99ao+15os51000000000000000000000000000
0000000000000000000000000000000000000000000000000000000000000000000000000000000000000000000000000000
000000000000000000000000000000000000000000000000000000000000a-99ao+15os51000000000000000000000000000
0000000000000000000000000000000000000000000000000000000000000000000000000000000000000000000000000000
0000000000000000000000000000000000000000000000000000000000000000000000000000000000000000000000000000
00000000000000000000000000000000000000000000000000000000000a-99ao+300os42000000000000000000000000000
00000000000000000000000000000000000000000000000000000000000a-99ao+300os42000000000000000000000000000
00000000000000000000000000000000000000000000000000000000000a-99ao+300os42000000000000000000000000000
0000000000000000000000000000000000000000000000000000000000000000000000000000000000000000000000000000
00000000000000000000000000000000000000000000000000000000000a-99ao+300os42000000000000000000000000000
00000000000000000000000000000000000000000000000000000000000a-99ao+300os42000000000000000000000000000
0000000000000000000000000000000000000000000000000000000000000000000000000000000000000000000000000000
0000000000000000000000000000000000000000000000000000000000000000000000000000000000000000000000000000
0000000000000000000000000000000000000000000000000000000000000000000000000000000000000000000000000000
0000000000000000000000000000000000000000000000000000000000000000000000000000000000000000000000000000
0000000000000000000000000000000000000000000000000000000000000000000000000000000000000000000000000000
0000000000000000000000000000000000000000000000000000000000000000000000000000000000000000000000000000
0000000000000000000000000000000000000000000000000000000000000000000000000000000000000000000000000000
0000000000000000000000000000000000000000000000000000000000000000000000000000000000000000000000000000
0000000000000000000000000000000000000000000000000000000000000000000000000000000000000000000000000000
0000000000000000000000000000000000000000000000000000000000000000000000000000000000000000000000000000
0000000000000000000000000000000000000000000000000000000000000000000000000000000000000000000000000000
0000000000000000000000000000000000000000000000000000000000000000000000000000000000000000000000000000
0000000000000000000000000000000000000000000000000000000000000000000000000000000000000000000000000000
0000000000000000000000000000000000000000000000000000000000000000000000000000000000000000000000000000
0000000000000000000000000000000000000000000000000000000000000000000000000000000000000000000000000000
0000000000000000000000000000000000000000000000000000000000000000000000000000000000000000000000000000
0000000000000000000000000000000000000000000000000000000000000000000000000000000000000000000000000000
0000000000000000000000000000000000000000000000000000000000000000000000000000000000000000000000000000
0000000000000000000000000000000000000000000000000000000000000000000000000000000000000000000000000000
0000000000000000000000000000000000000000000000000000000000000000000000000000000000000000000000000000
0000000000000000000000000000000000000000000000000000000000000000000000000000000000000000000000000000
0000000000000000000000000000000000000000000000000000000000000000000000000000000000000000000000000000
0000000000000000000000000000000000000000000000000000000000000000000000000000000000000000000000000000
0000000000000000000000000000000000000000000000000000000000000000000000000000000000000000000000000000
00000000000000000000000000000000000000000000000000000000000a+400ao-99os61000000000000000000000000000
0000000000000000000000000000000000000000000000000000000000000000000000000000000000000000000000000000
00000000000000000000000000000000000000000000000000000000000a+200ao-99os61000000000000000000000000000
0000000000000000000000000000000000000000000000000000000000000000000000000000000000000000000000000000
00000000000000000000000000000000000000000000000000000000000a+600ao-99os61000000000000000000000000000
0000000000000000000000000000000000000000000000000000000000000000000000000000000000000000000000000000
00000000000000000000000000000000000000000000000000000000000a+500ao-99os61000000000000000000000000000
0000000000000000000000000000000000000000000000000000000000000000000000000000000000000000000000000000
00000000000000000000000000000000000000000000000000000000000a+150ao-99os61000000000000000000000000000
00000000000000000000000000000000000000000000000000000000000a+250ao-99os61000000000000000000000000000
00000000000000000000000000000000000000000000000000000000000a+350ao-99os61000000000000000000000000000
00000000000000000000000000000000000000000000000000000000000a+450ao-99os61000000000000000000000000000
00000000000000000000000000000000000000000000000000000000000a+550ao-99os61000000000000000000000000000
0000000000000000000000000000000000000000000000000000000000000000000000000000000000000000000000000000
0000000000000000000000000000000000000000000000000000000000000000000000000000000000000000000000000000
0000000000000000000000000000000000000000000000000000000000000000000000000000000000000000000000000000
0000000000000000000000000000000000000000000000000000000000000000000000000000000000000000000000000000
0000000000000000000000000000000000000000000000000000000000000000000000000000000000000000000000000000
0000000000000000000000000000000000000000000000000000000000000000000000000000000000000000000000000000
0000000000000000000000000000000000000000000000000000000000000000000000000000000000000000000000000000
0000000000000000000000000000000000000000000000000000000000000000000000000000000000000000000000000000
00000000000000000000000000000000000000000000000000000000000a+500ao-99os61000000000000000000000000000
0000000000000000000000000000000000000000000000000000000000000000000000000000000000000000000000000000
00000000000000000000000000000000000000000000000000000000000a+600ao-99os61000000000000000000000000000
0000000000000000000000000000000000000000000000000000000000000000000000000000000000000000000000000000
00000000000000000000000000000000000000000000000000000000000a+200ao-99os61000000000000000000000000000
0000000000000000000000000000000000000000000000000000000000000000000000000000000000000000000000000000
00000000000000000000000000000000000000000000000000000000000a+400ao-99os61000000000000000000000000000
0000000000000000000000000000000000000000000000000000000000000000000000000000000000000000000000000000
00000000000000000000000000000000000000000000000000000000000a+550ao-99os61000000000000000000000000000
00000000000000000000000000000000000000000000000000000000000a+450ao-99os61000000000000000000000000000
00000000000000000000000000000000000000000000000000000000000a+350ao-99os61000000000000000000000000000
00000000000000000000000000000000000000000000000000000000000a+250ao-99os61000000000000000000000000000
00000000000000000000000000000000000000000000000000000000000a+150ao-99os61000000000000000000000000000
0000000000000000000000000000000000000000000000000000000000000000000000000000000000000000000000000000
0000000000000000000000000000000000000000000000000000000000000000000000000000000000000000000000000000
0000000000000000000000000000000000000000000000000000000000000000000000000000000000000000000000000000
0000000000000000000000000000000000000000000000000000000000000000000000000000000000000000000000000000
0000000000000000000000000000000000000000000000000000000000000000000000000000000000000000000000000000










